1111111111111111111111111111
10000000P0000000000000000001
1001110000C00000000000C11111
1000000000000000000000000001
1000CC0001000000C01100000001
100E001010000000000010100111
1000000000000000C00011100001
1111111111111111111111111111