1111111111111111111111111111
1000000000000000000000000001
1001110000000000011100000001
10000P000C0C00000000000C0C01
1C0001100000000C000110000001
1C0000101E00000C000010100011
1C0000111000000C000011100001
1111111111111111111111111111