1111111111111111111111111111
1000000000000000000000000001
1001110000000000011100M00001
10000P000C0C00000000000C0C01
1C0011000100M0C00011000000M1
1C0000101E00000C000010100011
1C0000111000000C000011100001
1111111111111111111111111111